R 1280 800                          
NO ./path_to_the_north_texture
S ./path_to_the_sprite_texture
SO ./path_to_the_south_texture
WE ./path_to_the_west_texture
EA ./path_to_the_east_texture
F 18, 4, 60                                
C 33, 1, 1
        1111111111111111111111111
        1000000000110000000000001111
        1011000001110000000000001
        100100000000000000000000111
111111111011000001110000000000001
1100000000110000011101111111111111111111111
 1110111111111011100000010000000000000001
1111011111111101110101001000000000000000111
11000000110101011100000010000000200000001
11111000000000000110000010000000000000001
    10000000000000001101100000200002000011
1111100111101011111110101000000000000000111111111
11000000110101011100000010000000000N00001
11000000110101011100000010000000000000001       11111111
1100000011010101110000001000000000001111111111111110001111
1100000011010101110000001000000000000000000000000000000001
11000001110101011100000010000000000000000000000000001000011111111111111111
11111111 1110101 10111101111111111111111111111111111111111
11111111 1111111 111111111111
