R 1240 800                    
NO ./path_to_the_north_texture
S ./path_to_the_sprite_texture
SO ./path_to_the_south_texture
WE ./path_to_the_west_texture
EA ./path_to_the_east_texture
F 18, 4, 60                                
C 33, 1, 1
        1111111111111111111111111
        1000000000110000000000001111
        1011000001110000000000001
        1001000000000000000000001
111111111011000001110000000000001
1100000000110000011101111111111111111111111
 1110111111111011100000010000000000000001
1111011111111101110101001000000000000000111
11000000110101011100000011110000000000011
1111100000000000011000001000000200000001
    1000000000000000110110000000000000011
11111001111010111111101010000000000000001111111111111111
11000000110101011100000010000000000000001111111111000111
1100000011010101110000001002000N000020001       111000111
1100000011010101110000001000000000001111111111111110001111
1100000011010101110000001000000000000000000000000000000001
11000001110101011100000010000002000000000000000000001000011111111111111111
11111111 1110101 10111101111111111111111111111111111111111
11111111 1111111 111111111111
