R 1280 800                          
NO ./path_to_the_north_texture
S ./path_to_the_sprite_texture


SO ./path_to_the_south_texture
WE ./path_to_the_west_texture
EA ./path_to_the_east_texture

F 0,255, 255                                    
C 0,0,255     

        1111111111111111111111111
        1000000000110000000000001111
        1011000001110000002000001
        100100000000000000000000111
111111111011000001110000000000001
1100000000110000011101111111111111111
 111011111111101110000001000100000001
1111011111111101110101001000100001111
1100000011010101110000001000000000001
1111120000000000011000001000000E000011
    1000000000000000110111111100000011
11  100111101011111110101000000000001111
11111111 1110101 101111011111111111111
11111111 1111111 111111111111
