

i = 0, x = 0
regel y || WHILE spatie, i++.			//i = 8
IF i > 0 THEN x[0] = '*'				//check
WHILE x < i,  

ONTHOU eerste niet spatie
regel y ||	ALS spatie && x <  





-------1111111111111111111111111/
---------1000000000110000000000001/
---1001111011000001110000002000001/
---------1001000000000000000000001/
-111111111011000001110000000000001/
-100000000011000001110111111111011/
-11110111111111011100000010001----/
-11110111111111011101010010001----/
-11000000110101011100000010001----/
110002000000000001100000010001----/
-10000000000000001101010010001----/
-11000001110101011111011110N0111--/
-10000000000000000000000000001----/
-11111111111111111111111111111----/
-------------0--------------------/
-------------1--------------------/

1. SAVE grootste STRLEN											//35

2.
----------
i = 0, x = 0
regel y || WHILE STR[i] == spatie, STR[i] == '-', i++. 			//i = 8
-----------

3. 
IF strlen < GROOTST STRLEN
	-------
	while (strlen + 1 < GROOTST STRLEN)
	i = 0;
	strlen + i == '-', i++;
	-------
	STR[GROOTSTE STRLEN == '\0']
	-------

4. 
Flood Fill 
IF == '1''
return (0)

if (TWOD[y][x]== '\0' || y < base->read.y_start || y > base->read.y_end)
	{
		printf("--error 12--[%d][%d]----\n", y, x);
		return (base->read.error = 12);	
	}

TWOD[y][x] = '';


----------
EERSTE POSITIE GEVULD van Y , Y + 1 en Y-1
> dan Y+-1
CHECK DAN OF OF VERSCHIL 1en zijn 


-------1111111111111111111111111/
---------1000000000110000000000001/
---1001111011000001110000002000001/
---------1001000000000000000000001/
-111111111011000001110000000000001/
-100000000011000001110111111111011/
-11110111111111011100000010001----/
-11110111111111011101010010001----/
-11000000110101011100000010001----/
110002000000000001100000010001----/
-10000000000000001101010010001----/
-11000001110101011111011110N0111--/
-10000000000000000000000000001----/
-11111111111111111111111111111----/
-------------0--------------------/
-------------1--------------------/

Eerste en laatste Y gevuld met 1, 0, N, S etc.
ALS y + 1


1111111111111111111111111
1000000000110000000000001
1011000001110000002000001
1001000000000000000000001
111111111011000001110000000000001
100000000011000001110111111111111
11110111111111011100000010001
11110111111111011101010010001
11000000110101011100000010001
10002000000000001100000010001
10000000000000001101010010001
11000001110101011111011110N0111
11110111 1110101 101111010001 11111111 1111111 111111111111