Valid
        1111111111111111111111111
        1000000000110000000000001
        1011000001110000002000001
        1001000000000000000000001
111111111011000001110000000000001
100000000011000001110111111111111
11110111111111011100000010001
11110111111111011101010010001
11000000110101011100000010001
10002000000000001100000010001
10000000000000001101010010001
11000001110101011111011110N0111
11110111 1110101 101111010001
11111111 1111111 111111111111

        1111111 11111111111111111
        1000001110110000000000001
        1011000001110000002000001
        1001000000000000000000001
111111111011000001110000000000001
100000000011000001110111111111111
11110111111111011100000010001
11110111111111011101010010001
11000000110101011100000010001
10002000000000001100000010001
10000000000000001101010010001
11000001110101011111011110N0111
11110111 1110101 101111010001
11111111 1111111 111111111111

#spaces behind

        1111111 11111111111111111   
        1000001110110000000000001
        1011000001110000002000001
        1001000000000000000000001
111111111011000001110000000000001
100000000011000001110111111111111    
11110111111111011100000010001
11110111111111011101010010001
11000000110101011100000010001
10002000000000001100000010001    
10000000000000001101010010001
11000001110101011111011110N0111   
11110111 1110101 101111010001
11111111 1111111 111111111111  

        1111111111111111111111111
        1000000000110000000000001111
        1011000001110000002000001
        100100000000000000000000111
111111111011000001110000000000001
100000000011000001110111111111111
11110111111111011100000010001
11110111111111011101010010001
11000000110101011100000010001
10002000000000001100000010001
10000000000000001101010010001
11000001110101011111011110N0111
11110111 1110101 101111010001
11111111 1111111 111111111111

        1111111111111111111111111
        1000000000110000000000001111
        1011000001110000002000001
        100100000000000000000000111
111111111011000001110000000000001
100000000011000001110111111011111
11110111111111011100000010001
11110111111111011101010010001
11000000110101011100000010001
10002000000000001100000010001
10000000000000001101010010001
11000001110101011111011110N0111
11110111 1110101 101111010001
11111111 1111111 111111111111

        1111111111111111111111111
        1000000000110000000000001111
        1011000001110000002000001
        100100000000000000000000111
  111111111011000001110000000000001
  100000000011000001110111111011111
  11110111111111011100000010001
  11110111111111011101010010001
  11000000110101011100000010001
1110002000000000001100000010001
  10000000000000001101010010001
  11000001110101011111011110N0111
  11110111 1110101 101111010001
  11111111 1111111 111111111111

        1111111111111111111111111
        1000000000110000000000001111
        1011000001110000002000001
        100100000000000000000000111
  111111111011000001110000000000001
  100000000011000001110111111011111
  11110111111111011100000010001
  11110111111111011101010010001
  11000000110101011100000010001
1110002000000000001100000010001
  10000000000000001101010010001
1 11000001110101011111011110N0111
  11110111 1110101 101111010001
  11111111 1111111 111111111111

        1111111111111111111111111
        1000000000110000000000001111
        1011000001110000002000001
        100100000000000000000000111
111111111011000001110000000000001
100000000011000001110111111011111
11110111111111011100000010001
11110111111111011101010010001
11000000110101011100000010001
111112000000000001100000010001
    10000000000000001101010010001
11111001110101011111011110N0111
11110111 1110101 101111010001
11111111 1111111 111111111111

        1111111111111111111111111
        1000000000110000000000001111
        1011000001110000002000001
        100100000000000000000000111
111111111011000001110000000000001
100000000011000001110111111011111
11110111111111011100000010001
11110111111111011101010010001
11000000110101011100000010001
111112000000000001100000010011
    10000000000000001101010011111
11111001110101011111011110N0111
11110111 1110101 101111010001
11111111 1111111 111111111111

        1111111111111111111111111
        1000000000110000000000001111
        1011000001110000002000001
        100100000000000000000000111
111111111011000001110000000000001
100000000011000001110111111011111
11110111111111011100000010001
11110111111111011101010010001
11000000110101011100000010001
111112000000000001100000010011
    10000000000000001101010011111
11  10011110101111111011110N1111
11111111 1110101 101111010001
11111111 1111111 111111111111
----------------------------------------------
Invalid

#first line 0
        1111111111111111111111011
        1000000000110000000000001
        1011000001110000002000001
        1001000000000000000000001
111111111011000001110000000000001
100000000011000001110111111111111
11110111111111011100000010001
11110111111111011101010010001
11000000110101011100000010001
10002000000000001100000010001
10000000000000001101010010001
11000001110101011111011110N0111
11110111 1110101 101111010001
11111111 1111111 111111111111

#niet gesloten muur
        11111 1111111111111111011
        1000000000110000000000001
        1011000001110000002000001
        1001000000000000000000001
111111111011000001110000000000001
100000000011000001110111111111111
11110111111111011100000010001
11110111111111011101010010001
11000000110101011100000010001
10002000000000001100000010001
10000000000000001101010010001
11000001110101011111011110N0111
11110111 1110101 101111010001
11111111 1111111 111111111111

        1111111 11111111111111111
        1000000110110000000000001
        1011000001110000002000001
        1001000000000000000000001
111111111011000001110000000000001
100000000011000001110111111111111
11110111111111011100000010001
11110111111111011101010010001
11000000110101011100000010001
10002000000000001100000010001
10000000000000001101010010001
11000001110101011111011110N0111
11110111 1110101 101111010001
11111111 1111111 111111111111

        1111111111111111111111111
        1000000000110000000000001101
        1011000001110000002000001
        100100000000000000000000111
111111111011000001110000000000001
100000000011000001110111111111111
11110111111111011100000010001
11110111111111011101010010001
11000000110101011100000010001
10002000000000001100000010001
10000000000000001101010010001
11000001110101011111011110N0111
11110111 1110101 101111010001
11111111 1111111 111111111111

        1111111111111111111111111
        1000000000110000000000000111
        1011000001110000002000001
        100100000000000000000000111
111111111011000001110000000000001
100000000011000001110111111111111
11110111111111011100000010001
11110111111111011101010010001
11000000110101011100000010001
10002000000000001100000010001
10000000000000001101010010001
11000001110101011111011110N0111
11110111 1110101 101111010001
11111111 1111111 111111111111

        1111111111111111111111111
        1000000000110000000000001
        1011000001110000002000001
        100100000000000000000000111
111111111011000001110000000000001
100000000011000001110111111111110
11110111111111011100000010001
11110111111111011101010010001
11000000110101011100000010001
10002000000000001100000010001
10000000000000001101010010001
11000001110101011111011110N0111
11110111 1110101 101111010001
11111111 1111111 111111111111

        1111111111111111111111111
        1000000000110000000000001
        1011000001110000002000001
        100100000000000000000000111
111111111011000001110000000000001
100000000011000001110111111101111
11110111111111011100000010001
11110111111111011101010010001
11000000110101011100000010001
10002000000000001100000010001
10000000000000001101010010001
11000001110101011111011110N0111
11110111 1110101 101111010001
11111111 1111111 111111111111

        1111111111111111111111111
        1000000000110000000000001111
        1011000001110000002000001
        100100000000000000000000111
111111111011000001110000000000001
100000000011000001110111111011111
11110111111111011100000010001
11110111111111011101010010001
11000000110101011100000010001
111112000000000001100000010001
    10000000000000001101010010001
11  10001110101011111011110N0111
11110111 1110101 101111010001
11111111 1111111 111111111111

#Invalid char in map
        1111111111111111111111111
        1000000000110000000000001111
        1011000001110000002000001
        100100000000000000000000111
111111111011000001110000000000001
100000000011000001110111111011111
11110111111111011100000010001
11110111111111011101010010001
11000000110101011100000010001
111112000000000001100000010011
    1000000003000000110101001111
11  10011110101111111011110N1111
11111111 1110101 101111010001
11111111 1111111 111111111111

#Double SNEW
        1111111111111111111111111
        1000000000110000000000001111
        1011000001110000002000001
        100100000000000000000000111
111111111011000001110000000000001
100000000011000001110111111011111
11110111111111011100000010001
11110111111111011101010010001
11000000110101011100000010001
111112000000000001100000010011
    100000000S000000110101001111
11  10011110101111111011110N1111
11111111 1110101 101111010001
11111111 1111111 111111111111

#hole in floor
        1111111111111111111111111
        1000000000110000000000001111
        1011000001110000002000001
        100100000000000000000000111
111111111011000001110000000000001
100000000011000001110111111011111
11110111111111011100000010001
11110111111111011101010010001
11000000110101011100000010001
111112000000000001100000010011
    100000000 000000110101001111
11  10011110101111111011110N1111
11111111 1110101 101111010001
11111111 1111111 111111111111