R 600 400                  
NO ./textures_xpm/wall_texture.xpm
EA ./textures_xpm/CrateOver.xpm
SO ./textures_xpm/Dirt.xpm
WE ./textures_xpm/OreVein.xpm
S2 ./sprites_xpm/barrel.xpm
S3 ./sprites_xpm/pink.xpm
S4 ./sprites_xpm/pillar.xpm
F ./textures_xpm/Sand.xpm
C ./textures_xpm/Ice.xpm

        111111111111111111111111111111111111111111111111111111111111111111
        111100000000000000000000000000000000000000000000303011111111111111
        11110020000000000400400400400400400400400400000300301111111111111
        1111000000000E0000000000000000000000000000000030003011111111111111
        11110000000000000400400400400400400400400400000300301111111111111
        11110000000000000000000000000000000000000000000030301111111111111
        111100000001111112111111111102201111111111111000000001111111111111
        11111000000000000000000000021111111111111111100000000111111111111
        11100000001300000000000000001   1111111111111111000001111111111111
        1111100000111100000000111111   1111111111111110000000111111111111
        11100000000000000000000000001   1111111111111111000002111111011111
        11100001111000110101010110001   1110000000000010000000002000202011111
        11100000000010000000000000001   111100000000001100000000002000311011111111111     
        11100000000010000020002000001   11110000000002000000000001111000004040401111111111111
        11111111111111111111111111111   111000000000001100000000000011000000000000000000011
                                        1110000000000100000000000000101004040404000110000011111 
                                        11100000000001000202000000001001111100001100000111111
                                        11111111111111112020211111111111111110000110000011
                                                11111111000001111111       110000110000011
                                                11111111000001111111       110000000000011
                                                11111111100011111111       110000000000011
                                                11111111100011111111       111111111111111
                                                11111111100011111111
                                                11100000000000002111
                                                11120000033000000111
                                                11111111111111111111