R 5000 8000         
NO ./textures_xpm/wall_texture.xpm
SO ./textures_xpm/Dirt.xpm
EA ./textures_xpm/CrateOver.xpm
WE ./textures_xpm/OreVein.xpm
C 33, 1, 1
S ./sprites_xpm/barrel.xpm
F 18, 4, 60                           

11111111111 111111111111
100000000111100000000001
100000000000000000000001
100000000000020000000001
100000000000000000000001
100000000000000000000001
100000000000000000000001
100000000000000N00000001
111111111111111111111111