R 5000 8000                  
NO ./textures_xpm/wall_texture.xpm
EA ./textures_xpm/CrateOver.xpm
SO ./textures_xpm/Dirt.xpm
WE ./textures_xpm/OreVein.xpm
S2 ./sprites_xpm/barrel.xpm
S3 ./sprites_xpm/pink.xpm
S4 ./sprites_xpm/pillar.xpm
F ./textures_xpm/Sand.xpm
C ./textures_xpm/Ice.xpm

        111111111111111111111111111111111111111111111111111111111111111111
        111100234000000000000000000000000000000000000000000001111111111111
        111100000000000000000000000040000000000000000000000001111111111111
        1111000000011111111111111111000001111111111111110000001111111111111
        1111100N0000000000000000000311111111111111111111000000111111111111
        11100000001300000000000000001   1111111111111111000001111111111111
        11111000001111000000000111111   1111111111111112000002111111111111
        11100000000000000000000000001   1111111111111112000002111111111111
        11100001111000110101010101001   1110000040000000000200000000000111
        11100000000010000000000000001   11110000400000000022200000000000111111111111111111     
        11100000000010000003000000001   11110000400000002022200000000000000000000011111111
        11111111111111111111111111111   11100000000000000000000000000000000000000000000011
                                        11100000003330000000000033000001111110000110000011 
                                        11100000000000000000000000000001111110000110000011
                                        11111111111111110000011111111111111110000110000011
                                                11111111000001111111       110000110000011
                                                11111111000001111111       110000000000011
                                                11111111100011111111       110000000000011
                                                11111111100011111111       111111111111111
                                                11111111100011111111
                                                11100000000000002111
                                                11120000000000000111
                                                11111111111111111111