R 5000 8000                  
NO ./textures_xpm/wall_texture.xpm
EA ./textures_xpm/CrateOver.xpm
SO ./textures_xpm/Dirt.xpm
WE ./textures_xpm/OreVein.xpm
S ./sprites_xpm/barrel.xpm
F 18, 4, 60                             
C 33, 1, 1

        1111111111111111111111111
        1000000000110000000000001111
        1011000001110000000000001
        1001000000000000000000001
111111111011000001110000000000001
1100000000110000011101111111111111111111111
 1110111111111011100000010000000000000001
1111011111111101110101001000000200000000111
11000000110101011100000011110000000000011
1111100000000000011000001000000200000001
    1000000000000000110110000000000000011
11111001111010111111101010000002000000001111111111111111
11000000110101011100000010000000000000001111111111000111
1100000011010101110000001002000S00020001       111000111
1100000011010101110000001000000000001111111111111110001111
1100000011010101110000001000000000000000000000000000000001
1100000111010101110000001000000210000000000000000000011111111111111111
11111111 1110101 10111101111111111111111111111111111111111
11111111 1111111 111111111111
