R 5000 8000                  
NO ./textures_xpm/wall_texture.xpm
EA ./textures_xpm/CrateOver.xpm
SO ./textures_xpm/Dirt.xpm
WE ./textures_xpm/OreVein.xpm
S ./sprites_xpm/barrel.xpm
F 18, 4, 60                             
C 33, 1, 1

111111111111111111111111
100000000000000000000001
100000000000000000000001
100000000000000000000001
100000000000000000000001
10000000000000N000000001
100000000000000000000001
100000000000000000000001
111111111111111 11111111