R 5000 8000                  
NO ./textures_xpm/wall_texture.xpm
EA ./textures_xpm/CrateOver.xpm
SO ./textures_xpm/Dirt.xpm
WE ./textures_xpm/OreVein.xpm
S ./sprites_xpm/barrel.xpm
F 18, 4, 60                             
C 33, 1, 1

            1111111111111111111111111
            1000000000110000020011111
        1111100001110000000000001
        1001000200000000020000001
111111111011000001110000000000001
100200002011000001110111111111111
11110000011111011100000010001
11110111111111011101010010001
11220002110101011100000010001
12000200200201020000000000201
1200E002020200011010102010001
10000021110101011111011110001
11000111 1110101 101111010001
11111111 1111111 111111111111